1)    * * *
      *   *
      * * *
      
2)    * * * * *
      *       *
      *       *
      *       *
      * * * * *           